+---+---+---+---+---+
        |           |
        |           |
        |           |
+---+   +---+---+   +
|   |           |   |
|   |   m       |   |
|   |           |   |
+   +---+   +---+   +
|   |   |   |       |
|   |   |   |       |
|   |   | h |       |
+   +   +   +   +   +
|       |       |   |
|       |       |   |
|       |       |   |
+   +---+---+---+   +
|                    
|                    
|                    
+---+---+---+---+---+