+---+---+---+---+---+---+
        |               |
        |               |
        |               |
+---+   +   +---+---+---+
|       |       |       |
|       |       |       |
|       |       |       |
+   +---+   +   +   +   +
|       |   |       |   |
|       |   |   m   |   |
|       |   |       |   |
+---+   +   +---+---+   +
|       |           |   |
|       |           |   |
|       |           |   |
+   +---+---+---+---+   +
|       |     h     |   |
|       |           |   |
|       |           |   |
+   +---+   +---+   +   +
|           |            
|           |            
|           |            
+---+---+---+---+---+---+